10,10
XXXXDDXXXX
XFFFFFFFFX
XFFFFFFFFX
XFFFFFFFFX
XFFFSFFFFX
XFFFFFFFFX
XFFFFFFFFX
XFFFFFFFFX
XFFFFFFFFX
XXXXXXXXXX