10,10
XXXXDDXXXX
XFFFFFFFFX
XFFFFF    
XFFFFF  FX
XFFFSF FFX
XFFFFFFFFX
XFFFFFFFFX
XFFFFFFFFX
XFFFFFFFFX
XXXXXXXXXX